import React from 'react';
import ReactTestUtils from 'react-dom/test-utils';
import ReactDOM from 'react-dom';
import styles from './Input.scss';

const inputDriverFactory = ({element, wrapper, component}) => {
  const input = element && element.querySelector('input');
  const clearButton = element && element.querySelector(`.${styles.clearButton}`);
  const suffixNode = element && element.querySelector(`.${styles.suffix}`);

  const driver = {
    trigger: (trigger, event) => ReactTestUtils.Simulate[trigger](input, event),
    focus: () => {
      input.focus();
      ReactTestUtils.Simulate.focus(input);
    },
    blur: () => {
      input.blur();
      ReactTestUtils.Simulate.blur(input);
    },
    keyDown: key => ReactTestUtils.Simulate.keyDown(input, {key}),
    clickSuffix: () => ReactTestUtils.Simulate.click(suffixNode),
    clickClear: () => ReactTestUtils.Simulate.click(clearButton),
    clearText: () => driver.enterText(''),
    enterText: text => ReactTestUtils.Simulate.change(input, {target: {value: text}}),
    getValue: () => input.value,
    getPlaceholder: () => input.placeholder,
    getDefaultValue: () => input.defaultValue,
    getTabIndex: () => input.tabIndex,
    getReadOnly: () => input.readOnly,
    getTextOverflow: () => input.style['text-overflow'],
    getAriaLabel: () => input.getAttribute('aria-label'),
    getAriaControls: () => input.getAttribute('aria-controls'),
    getAriaDescribedby: () => input.getAttribute('aria-describedby'),
    getAutocomplete: () => input.getAttribute('autocomplete'),
    getRequired: () => input.required,
    getType: () => input.type,
    hasPrefix: () => element.querySelectorAll(`.${styles.prefix}`).length === 1,
    hasPrefixClass: () => element.querySelectorAll(`.${styles.input}.${styles.withPrefix}`).length === 1,
    hasSuffix: () => !!suffixNode,
    hasSuffixClass: () => element.querySelectorAll(`.${styles.input}.${styles.withSuffix}`).length === 1,
    hasSuffixesClass: () => element.querySelectorAll(`.${styles.input}.${styles.withSuffixes}`).length === 1,
    prefixComponentExists: style => !!element.querySelector(`.${styles.prefix} ${style}`),
    suffixComponentExists: style => !!element.querySelector(`.${styles.suffix} ${style}`),
    isMenuArrowLast: () => element.querySelectorAll(`.${styles.suffixes} .${styles.suffix}:last-child > .${styles.menuArrow}`).length === 1,
    hasExclamation: () => !!element.querySelector(`.${styles.exclamation}`),
    hasHelp: () => !!element.querySelector(`.${styles.help}`),
    hasError: () => element.classList.contains(styles.hasError),
    getTooltipElement: () => element,
    getTooltipDataHook: () => 'input-tooltip',
    getDataHook: () => element.getAttribute('data-hook'),
    getUnit: () => element.querySelector(`.${styles.unit}`).textContent,
    hasMagnifyingGlass: () => !!element.querySelector(`.${styles.magnifyingGlass}`),
    hasMenuArrow: () => !!element.querySelector(`.${styles.menuArrow}`),
    hasClearButton: () => !!clearButton,
    isRTL: () => element.className.indexOf(styles.rtl) >= 0,
    isFocusedStyle: () => element.classList.contains(styles.hasFocus),
    isHoveredStyle: () => element.classList.contains(styles.hasHover),
    isDisabled: () => element.classList.contains(styles.disabled),
    isOfStyle: style => element.classList.contains(styles[`theme-${style}`]),
    isOfSize: size => element.classList.contains(styles[`size-${size}`]),
    isFocus: () => document.activeElement === input,
    exists: () => !!(element && element.querySelector('input')),
    startComposing: () => ReactTestUtils.Simulate.compositionStart(input),
    endComposing: () => ReactTestUtils.Simulate.compositionEnd(input),
    getCursorLocation: () => input.selectionStart,
    setProps: props => {
      const ClonedWithProps = React.cloneElement(component, Object.assign({}, component.props, props), ...(component.props.children || []));
      ReactDOM.render(ClonedWithProps, wrapper);
    }
  };

  return driver;
};

export default inputDriverFactory; 